*****E***
* * * * *
* * * * *
* *     *
* ***** *
*       *
* *******
*       *
*S******* 